8 8 8 8 8 8 8 8 8 8 8 8 8 8 8 8 8 8 8 8 8 8 8 8 8 8 8 8 8 8 8 8 8 8 8 8 8 8 8 8 8 8 8 8 8 8 8 8 8 8
8 3 2 0 1 3 2 0 1 3 2 0 1 3 2 0 1 3 2 0 1 3 2 0 1 3 2 0 1 3 2 0 1 3 2 0 1 3 2 0 1 3 2 0 1 3 2 0 1 8
8 2 1 3 0 2 1 3 0 2 1 3 0 2 1 3 0 2 1 3 0 2 1 3 7 8 1 3 0 2 1 3 0 2 1 3 0 2 1 3 0 2 1 3 0 2 1 3 0 8
8 1 0 2 3 1 0 2 3 1 0 2 3 1 0 2 3 0 3 1 2 0 3 1 2 8 3 1 2 0 3 1 2 0 3 1 2 0 3 1 2 0 3 1 2 0 3 1 2 8
8 0 3 1 2 0 3 1 2 0 3 1 2 0 3 1 2 1 2 3 0 1 2 3 0 8 2 3 0 1 2 3 0 1 2 3 0 1 2 3 0 1 2 3 0 1 2 3 0 8
8 3 2 0 1 3 2 0 1 3 2 0 1 3 2 0 1 3 0 1 2 3 0 1 2 3 0 1 2 3 0 1 2 3 0 1 2 3 0 1 2 3 0 1 2 3 0 1 2 8
8 2 1 3 0 2 1 3 0 2 1 3 0 2 1 3 0 2 1 3 0 2 1 3 0 2 1 3 0 2 1 3 0 2 1 3 0 2 1 3 0 2 1 3 0 2 1 3 0 8
8 1 0 2 3 1 0 2 3 1 0 2 3 1 0 2 3 1 0 2 3 1 0 2 3 1 0 2 3 1 0 2 3 1 0 2 3 1 0 2 3 1 0 2 3 1 0 2 3 8
8 2 1 0 3 1 2 3 0 2 1 3 0 2 3 1 2 0 3 1 2 0 3 1 2 0 3 1 2 0 3 1 2 0 3 1 2 0 3 1 2 0 3 1 2 0 3 1 2 8
8 1 3 2 0 3 1 2 3 0 1 2 3 0 1 2 3 1 0 2 3 1 0 2 3 1 0 2 3 1 0 2 3 1 0 2 3 1 0 2 3 1 0 2 3 1 0 2 3 8
8 3 0 1 2 1 0 3 2 3 0 1 2 3 0 1 2 3 2 1 0 3 2 1 0 3 2 1 0 3 2 1 0 3 2 1 0 3 2 1 0 3 2 1 0 3 2 1 0 8
8 2 3 0 1 2 3 0 1 2 3 0 1 2 3 0 1 0 3 2 1 2 3 0 1 2 3 0 1 2 3 0 1 2 3 0 1 2 3 0 1 2 3 0 1 2 3 0 1 8
8 0 1 2 3 0 1 2 3 0 1 2 3 0 1 2 3 2 1 0 3 0 1 2 3 0 1 2 3 0 1 2 3 0 1 2 3 0 1 2 3 0 1 2 3 0 1 2 3 8
8 67 67 67 67 67 67 67 67 67 67 67 67 1 0 3 2 1 0 3 2 1 0 3 2 1 0 3 2 1 0 3 2 1 0 3 2 1 0 3 2 1 0 8
8 67 67 67 67 67 67 67 67 67 67 67 67 3 2 1 0 3 2 1 0 3 2 1 0 3 2 1 0 3 2 1 0 3 2 1 0 3 2 1 0 3 2 8
8 67 67 67 67 67 67 67 67 67 67 67 67 1 0 3 2 1 0 3 2 1 0 3 2 1 0 3 2 1 0 3 2 1 0 3 2 1 0 3 2 1 0 8
8 67 67 67 67 67 67 67 67 67 67 67 67 0 1 2 1 3 2 0 3 1 2 0 1 3 0 2 1 3 2 0 3 1 2 0 1 3 0 2 1 3 2 8 0 3 1 0 2 8
8 67 67 67 67 67 67 67 67 67 67 67 67 2 3 0 2 1 0 3 1 0 3 2 3 2 1 0 3 2 1 0 1 2 3 0 2 1 0 3 1 0 3 2 3 2 1 0 3 8
8 67 67 67 67 67 67 67 67 67 67 67 67 1 2 0 1 2 3 0 2 3 0 1 2 1 3 0 2 1 3 0 2 3 0 1 2 1 3 0 2 3 0 1 2 1 3 0 2 8
8 67 67 67 67 67 67 67 67 67 67 67 67 3 0 2 3 0 1 2 1 3 2 0 3 0 1 2 1 3 2 0 3 1 0 2 3 0 1 2 1 3 2 0 3 1 0 2 3 8
8 67 67 67 67 67 67 67 67 67 67 67 67 1 3 0 1 2 3 0 2 1 0 3 1 2 3 0 2 1 3 0 1 2 3 0 2 1 3 0 1 2 3 0 2 1 3 0 1 8
8 67 67 67 67 67 67 67 67 67 67 67 67 2 1 3 0 2 1 3 0 1 2 3 0 1 2 3 0 1 2 3 0 1 2 3 0 1 2 3 0 1 2 3 0 1 2 3 0 8
8 67 67 67 67 67 67 67 67 67 67 67 67 3 1 0 2 3 1 0 2 3 1 0 2 3 1 0 2 3 1 0 2 3 1 0 2 3 1 0 2 3 3 0 3 1 0 2 3 8
8 3 2 0 1 3 2 0 1 3 2 0 1 3 2 0 1 3 2 0 1 3 2 0 1 3 2 0 1 3 2 0 1 3 2 0 1 3 2 0 1 3 2 0 1 3 2 0 1 8
8 2 1 3 0 2 1 3 0 2 1 3 0 2 1 3 0 2 1 3 0 2 1 3 7 8 1 3 0 2 1 3 0 2 1 3 0 2 1 3 0 2 1 3 0 2 1 3 0 8
8 1 0 2 3 1 0 2 3 1 0 2 3 1 0 2 3 0 3 1 2 0 3 1 2 8 3 1 2 0 3 1 2 0 3 1 2 0 3 1 2 0 3 1 2 0 3 1 2 8
8 0 3 1 2 0 3 1 2 0 3 1 2 0 3 1 2 1 2 3 0 1 2 3 0 8 2 3 0 1 2 3 0 1 2 3 0 1 2 3 0 1 2 3 0 1 2 3 0 8
8 3 2 0 1 3 2 0 1 3 2 0 1 3 2 0 1 3 0 1 2 3 0 1 2 3 0 1 2 3 0 1 2 3 0 1 2 3 0 1 2 3 0 1 2 3 0 1 2 8
8 2 1 3 0 2 1 3 0 2 1 3 0 2 1 3 0 2 1 3 0 2 1 3 0 2 1 3 0 2 1 3 0 2 1 3 0 2 1 3 0 2 1 3 0 2 1 3 0 8
8 1 0 2 3 1 0 2 3 1 0 2 3 1 0 2 3 1 0 2 3 1 0 2 3 1 0 2 3 1 0 2 3 1 0 2 3 1 0 2 3 1 0 2 3 1 0 2 3 8
8 0 3 1 2 0 3 1 2 0 3 1 2 0 3 1 2 3 2 1 0 3 2 1 0 3 2 1 0 3 2 1 0 3 2 1 0 3 2 1 0 3 2 1 0 3 2 1 0 8
8 3 2 0 1 3 2 0 1 3 2 0 1 3 2 0 1 0 3 2 1 0 3 2 1 0 3 2 1 0 3 2 1 0 3 2 1 0 3 2 1 0 3 2 1 0 3 2 1 8
8 2 1 3 0 2 1 3 0 2 1 3 0 2 1 3 0 2 1 3 0 2 1 3 0 2 1 3 0 2 1 3 0 2 1 3 0 2 1 3 0 2 1 3 0 2 1 3 0 8
8 1 0 2 3 1 0 2 3 1 0 2 3 1 0 2 3 1 0 2 3 1 0 2 3 1 0 2 3 1 0 2 3 1 0 2 3 1 0 2 3 1 0 2 3 1 0 2 3 8
8 0 3 1 2 0 3 1 2 0 3 1 2 0 3 1 2 3 2 1 0 3 2 1 0 3 2 1 0 3 2 1 0 3 2 1 0 3 2 1 0 3 2 1 0 3 2 1 0 8
8 3 2 0 1 3 2 0 1 3 2 0 1 3 2 0 1 0 3 2 1 0 3 2 1 0 3 2 1 0 3 2 1 0 3 2 1 0 3 2 1 0 3 2 1 0 3 2 1 8
8 2 1 3 0 2 1 3 0 2 1 3 0 2 1 3 0 2 1 3 0 2 1 3 0 2 1 3 0 2 1 3 0 2 1 3 0 2 1 3 0 2 1 3 0 2 1 3 0 8
8 1 0 2 3 1 0 2 3 1 0 2 3 1 0 2 3 1 0 2 3 1 0 2 3 1 0 2 3 1 0 2 3 1 0 2 3 1 0 2 3 1 0 2 3 1 0 2 3 8
8 0 3 1 2 0 3 1 2 0 3 1 2 0 3 1 2 3 2 1 0 3 2 1 0 3 2 1 0 3 2 1 0 3 2 1 0 3 2 1 0 3 2 1 0 3 2 1 0 8
8 3 2 0 1 3 2 0 1 3 2 0 1 3 2 0 1 0 3 2 1 0 3 2 1 0 3 2 1 0 3 2 1 0 3 2 1 0 3 2 1 0 3 2 1 0 3 2 1 8
8 2 1 3 0 2 1 3 0 2 1 3 0 2 1 3 0 2 1 3 0 2 1 3 0 2 1 3 0 2 1 3 0 2 1 3 0 2 1 3 0 2 1 3 0 2 1 3 0 8
8 1 0 2 3 1 0 2 3 1 0 2 3 1 0 2 3 1 0 2 3 1 0 2 3 1 0 2 3 1 0 2 3 1 0 2 3 1 0 2 3 1 0 2 3 1 0 2 3 8
8 0 3 1 2 0 3 1 2 0 3 1 2 0 3 1 2 3 2 1 0 3 2 1 0 3 2 1 0 3 2 1 0 3 2 1 0 3 2 1 0 3 2 1 0 3 2 1 0 8
8 3 2 0 1 3 2 0 1 3 2 0 1 3 2 0 1 0 3 2 1 0 3 2 1 0 3 2 1 0 3 2 1 0 3 2 1 0 3 2 1 0 3 2 1 0 3 2 1 8
8 2 1 3 0 2 1 3 0 2 1 3 0 2 1 3 0 2 1 3 0 2 1 3 0 2 1 3 0 2 1 3 0 2 1 3 0 2 1 3 0 2 1 3 0 2 1 3 0 8
8 1 0 2 3 1 0 2 3 1 0 2 3 1 0 2 3 1 0 2 3 1 0 2 3 1 0 2 3 1 0 2 3 1 0 2 3 1 0 2 3 1 0 2 3 1 0 2 3 8
8 0 3 1 2 0 3 1 2 0 3 1 2 0 3 1 2 3 2 1 0 3 2 1 0 3 2 1 0 3 2 1 0 3 2 1 0 3 2 1 0 3 2 1 0 3 2 1 0 8
8 3 2 0 1 3 2 0 1 3 2 0 1 3 2 0 1 0 3 2 1 0 3 2 1 0 3 2 1 0 3 2 1 0 3 2 1 0 3 2 1 0 3 2 1 0 3 2 1 8
8 8 8 8 8 8 8 8 8 8 8 8 8 8 8 8 8 8 8 8 8 8 8 8 8 8 8 8 8 8 8 8 8 8 8 8 8 8 8 8 8 8 8 8 8 8 8 8 8 8
