1 0 3 3 6 4 5 2 1 0 1 3 2 0 1 2
3 2 0 1 6 4 5 3 0 2 3 1 1 2 0 3
2 0 1 2 6 4 5 1 3 1 2 0 2 3 3 0
0 3 2 0 6 4 5 0 2 3 0 1 3 1 2 2
3 1 3 2 6 4 5 2 0 3 1 2 0 2 3 1
1 2 0 3 6 4 5 0 3 1 2 0 3 0 1 2
2 3 1 0 6 4 5 1 2 0 3 3 1 2 0 0
0 1 2 3 6 4 5 3 1 2 0 3 2 3 1 0
3 0 3 1 6 4 5 2 3 0 2 1 0 3 2 1
1 2 0 2 6 4 5 3 0 1 3 2 1 0 3 2
2 3 1 0 6 4 5 0 2 3 1 0 3 1 0 2
0 1 2 3 6 4 5 3 1 2 0 3 2 0 1 3